%%%%%%%%%%%%%%%%%%%%%%%%%%%
%%%%%%%%%%%%%%%%%%%%%%%%%%%
%%%%%%%%%%%%%%%%%%%%%%%%%%%
%%%%%%   %%%%%%%%%%%%%%%%%%
%%%%%%   %%%%%%%%%%%%%%%%%%
%%%%%%%%%%%%%%%%%%%%%%%%%%%
%%%%%%%%%%%%%%%%%%%%%%%%%%%
%%%%           %%%%%%%%%%%%
%%%%            %%%%%%%%%%%
%%%%            %%%%%%%%%%%
%%%%%%%%%%%%%%%%%%%%%%%%%%%
%%%%%%%%%%%%%%%%%%%%%%%%%%%
%%%%%%%%%%%%%%%%%%%%%%%%%%%
%%%%%%%%%%%%%%%%%%%%%%%%%%%
%%%%    %%%%%%%%%%%%%%%%%%%
%%%%   %%%%%%%%%%%%%%%%%%%%
%%%%  %%%%%%%%%%%%%%%%%%%%%
%%%% %%%%%%%%%%%   %%%%%%%%
%%%%%%%%%%%%%%%%   %%%%%%%%
%%%%%%%%%%%%%%%%%%%%%%%%%%%
%%%%%%%%%%%%%%%%%%%%%%%%%%%
%%%%%%%%%%%%%%%%%%%%%%%%%%%
#
%%%%%%%%%%%%%%%%%%%%%%%%%%%
%%%%%%%%%%%%%%%%%%%%%%%%%%%
%%%%%%%%%%%%%%%%%%%%%%%% %%
%%%%P     %%%%%%%%%%%%%%%%%
%%%%%%%%%%%%%%%%%%%%%%%%%%%
%%%%%%%%%%%%%%%%%%%% %%%%%%
%%%%%%%%%%%%%%%%%%%%  %%%%%
%%%%%%%%%%%%%   %%%%% %%%%%
%%               %%%% %%%%%
%%               %%%%% %%%%
%%  %%%%%%%%%%%%%%%%%% %%%%
%%  %%%%%%%%%%%%%%%%%% %%%%
%%  %%%%%%%%%%%%%%%%%%  %%%
%%   %%%%%%%%%%%%%%%%% %%%%
%%       %%%%%%%%%%%%%%%%%%
%%      %%%%%%%%%%%%%%%%%%%
%%     %%%%%%%%%%%%%%%%%%%%
%%    %%%%%%%%%      %%% %%
%%   %%%%%.%%%%      %%% %%
%%  %%%%%%%%%%%%%%%%%%%% %%
%%%%%%%%%%%%%%%%%%%%%%%%%%%
%%%%%%%%%%%%%%%%%%%%%%%%%%%
#
%%%%%%%%%%%%%%%%%%%%%%%%%%%
%%%%%%%%%%%%%%%%%%%%%%%%%%%
%%%%%%%%%%%%%%%%%%%%%%%%%%%
%%%%%%%%%%%%%%%%%%%%%%%%%%%
%%%%%%%%%%%%%%%%%%%%%%%%%%%
%%%%%%%%%%%%%%%%%%%%%%%%%%%
%%%%%%%%%%%%%%%%%%%%%%%%%%%
%%%%%%%%%%%%%%%%%%%%% %%%%%
%%%%%%%%%%%%%%%%%%%%% %%%%%
%%  %%%%%%%%%%%%%%%%%% %%%%
%%  %%%%%%%%%%%%%%%%%% %%%%
%%  %%%%%%%%%%%%%%%%%% %%%%
%%  %%%%%%%%%%%%%%%%%% %%%%
%%  %%%%%%%%%%%%%%%%%%%%%%%
%%  %%%%%%%%%%%%%%%%%%%%%%%
%%   %%%%%%%%%%%%%%%%%%%%%%
%%    %%%%%%%%%%%%%%%%%%%%%
%%   %%%%%%%%%%%%%%%%%%%%%%
%%%%%%%%%%%%%%%%%%%%%%%%%%%
%%%%%%%%%%%%%%%%%%%%%%%%%%%
%%%%%%%%%%%%%%%%%%%%%%%%%%%
%%%%%%%%%%%%%%%%%%%%%%%%%%%
#
