%%%%%%%%%%%%%%%%%%%%%%%%%%%%%%%%%%%%%%%%%%%%%%%%%%%%%
%%%%%%%%%%%%%%%%%%%%%%%%%%%%%%%%%%%%%%%%%%%%%%%%%%%%%
%%%%%%%%%%%%%%%%%%%%%%%%%%%                    %%%%%%
%%%%%%%%%%%%%%%%%%%%%%%%%%%%                   %%%%%%
%%%%%%%%%%      %%%%%%%%%%%%%                  %%%%%%
%%%%%%%%%%       %%%%%%%%%%%%%%%%%%%%%%%%%%%%%%%%%%%%
%%%%%%%%%%        %%%%%%%%%%%%%%%%%%%%%%%%%%%%%%%%%%%
%%%%%%%%%%         %%%%%%%%%%%%%%%%%%%%%%%%%%%%%%%%%%
%%%%%%%%%%                             %%%%%%%%%%%%%%
%%%%%%%%%%       %%%%%%%%%%%%%%%%%%%%%%%%%%%%%%%%%%%%
%%%%%%%%%%%%%%%%%%%%%%%%%%%%%%%%%%%%%%%%%%%%%%%%%%%%%
%%%%%%%%%%%%%%%%%%%%%%%%%%%%%%%%%%%%%%%%%%%%%%%%%%%%%
%%%%%%%%%%%%%%%%%%%%%%%%%%%% %%%%%%%%%%%%%%%%%%%%%%%%
%%%%%%                        %%%%%%%%%%%%%%%%%%%%%%%
%%%%%%                        %%%%%%%%%%%%%%%%%%%%%%%
%%%%%%                         %%%%%%%%%%%%%%%%%%%%%%
%%%%%%                         %%%%%%%%%%%%%%%%%%%%%%
%%%%%%                          %%%%%%%%%%%%%%%%%%%%%
%%%%%%                          %%%%%%%%%%%%%%%%%%%%%
%%%%%%                           %%%%%%%%%%%%%%%%%%%%
%%%%%%                           %%%%%%%%%%%%%%%%%%%%
%%%%%%%%%%%%%%%%%%%%%%%%%%%%%%%%%%%%%%%%%%%%%%%%%%%%%
%%%%%%%%%%%%%%%%%%%%%%%%%%%%%%%%%%%%%%%%%%%%%%%%%%%%%
%%%%%%%%%%%%%%%%%%%%%%%%%%%%%%%%%%%%%%%%%%%%%%%%%%%%%
%%%%%%%%%%%%%%%%%%%%%%%%%%%%%%%%%%%%%%%%%%%%%%%%%%%%%
%%%%%%%%%%%%%%%%%%%%%%%%%%%%%%%%%%%%%%%%%%%%%%%%%%%%%
%%%%%%                             %%%%%%%%%%%%%%%%%%
%%%%%%                             %%%%%%%%%%%%%%%%%%
%%%%%%                             %%%%%%%%%%%%%%%%%%
%%%%%%         %%%%%%%%%%%%%%%%%%%%%%%%%%%%%%%%%%%%%%
%%%%%%        %%%%%%%%%%%%%%%%%%%%%%%%%%%%%%%%%%%%%%%
%%%%%%       %%%%%%%%%%%%%%%%%%%%%%%%%%%%%%%%%%%%%%%%
%%%%%%      %%%%%%%%%%%%%%%%%%%        %%%%%%%%%%%%%%
%%%%%%     %%%%%%%%%%%%%%%%%%%%        %%%%%%%%%%%%%%
%%%%%%    %%%%%%%%%%%%%%%%%%%%%        %%%%%%%%%%%%%%
%%%%%%   %%%%%%%%%%%%%%%%%%%%%%        %%%%%%%%%%%%%%
%%%%%%  %%%%%%%%%%%%%%%%%%%%%%%        %%%%%%%%%%%%%%
%%%%%% %%%%%%%%%%%%%%%%%%%%%%%%        %%%%%%%%%%%%%%
%%%%%%%%%%%%%%%%%%%.%%%%%%%%%%%        %%%%%%%%%%%%%%
%%%%%%%%%%%%%%%%%%%%%%%%%%%%%%%%%%%%%%%%%%%%%%%%%%%%%
%%%%%%%%%%%%%%%%%%%%%%%%%%%%%%%%%%%%%%%%%%%%%%%%%%%%%
%%%%%%%%%%%%%%%%%%%%%%%%%%%%%%%%%%%%%%%%%%%%%%%%%%%%%
%%%%%%%%%%%%%%%%%%%%%%%%%%%%%%%%%%%%%%%%%%%%%%%%%%%%%
#
%%%%%%%%%%%%%%%%%%%%%%%%%%%%%%%%%%%%%%%%%%%%%%%%%%%%%
%%%%%%%%%%%%%%%%%%%%%%%%%%%%%%%%%%%%%%%%%%%%%%%%%%%%%
%%%%%%%%%%%%%%%%%%%%%%%%%%%%%%%%%%%%%%%%%%%%%%%%%%%%%
%%%%%%%%%%%%%%%%%%%%%%%%%%%%%%%%%%%%%%%%%%%%%%%%%%%%%
%%%%%%%%%%%%%%%%%%%%%%%%%%%%%%%%%%%%%%%%%%%%%%%  %%%%
%%%%%%%%%%%%%%%%%%%%%%%%%%%%%%%%%%%%%%%%%%%%%%%% %%%%
%%%%%%%%P           %%%%%%%%%%%%%%%%%%%%%%%%%%%% %%%%
%%%%%%%%             %%%%%%%%%%%%%%%%%%%%%%%%%%% %%%%
%%%%%%%%%%%%%%%%%%%%%%%%%%%%%%%%%%%%%%%%%%%%%%%%%%%%%
%%%%%%%%%%%%%%%%%%%%%%%%%%%%%%%%%%%%%%%%%%%%%%%%%%%%%
%%%%%%%%%%%%%%%%%%%%%%%%%%%%%%%%%%%%%%     %%%%%%%%%%
%%%%%%%%%%%%%%%%%%%%%%%%%%%%%%%%%%%%%%%    %%%%%%%%%%
%%%%%%%%%%%%%%%%%%%%%%%%%%%%%%%%%%%%%%%    %%%%%%%%%%
%%%%%%%%%%%%%%%%%%%%%%%%%%%%%%%%%%%%%%%%    %%%%%%%%%
%%%%%%%%%%%%%%%%%%%%%%           %%%%%%%    %%%%%%%%%
%%%%                             %%%%%%%%   %%%%%%%%%
%%%%                              %%%%%%%    %%%%%%%%
%%%%                              %%%%%%%%   %%%%%%%%
%%%%                               %%%%%%%    %%%%%%%
%%%%     %%%%%%%%%%%%%%%%%%%%%%%%%%%%%%%%%%   %%%%%%%
%%%%    %%%%%%%%%%%%%%%%%%%%%%%%%%%%%%%%%%%   %%%%%%%
%%%%   %%%%%%%%%%%%%%%%%%%%%%%%%%%%%%%%%%%%%   %%%%%%
%%%%   %%%%%%%%%%%%%%%%%%%%%%%%%%%%%%%%%%%%%   %%%%%%
%%%%   %%%%%%%%%%%%%%%%%%%%%%%%%%%%%%%%%%%%%   %%%%%%
%%%%   %%%%%%%%%%%%%%%%%%%%%%%%%%%%%%%%%%%%%   %%%%%%
%%%%      %%%%%%%%%%%%%%%%%%%%%%%%%%%%%%%%%%   %%%%%%
%%%%      %%%%%%%%%%%%%%%%%%%%%%%%%%%%%%%%%%  %%%%%%%
%%%%      %%%%%%%%%%%%%%%%%%%%%%%%%%%%%%%%%% %%%%%%%%
%%%%              %%%%%%%%%%%%%%%%%%%%%%%%%%%%%%%%%%%
%%%%             %%%%%%%%%%%%%%%%%%%%%%%%%%%%%%%%%%%%
%%%%            %%%%%%%%%%%%%%%%%%%%%%%%%%%%%%%%%%%%%
%%%%           %%%%%%%%%%%%%%%%%%%%%%%%%%%%%%%%%%%%%%
%%%%          %%%%%%%%%%%%%%%%%%%%%%%%%%%%%%%%%%%%%%%
%%%%         %%%%%%%%%%%%%%%%%%%%%%%%%%%%%%%%%%% %%%%
%%%%        %%%%%%%%%.%%%%%%%            %%%%%%% %%%%
%%%%       %%%%%%%%%..%%%%%%%            %%%%%%% %%%%
%%%%      %%%%%%%%%...%%%%%%%            %%%%%%% %%%%
%%%%     %%%%%%%%%%%%%%%%%%%%%%%%%%%%%%%%%%%%%%% %%%%
%%%%    %%%%%%%%%%%%%%%%%%%%%%%%%%%%%%%%%%%%%%%% %%%%
%%%%%%%%%%%%%%%%%%%%%%%%%%%%%%%%%%%%%%%%%%%%%%%%%%%%%
%%%%%%%%%%%%%%%%%%%%%%%%%%%%%%%%%%%%%%%%%%%%%%%%%%%%%
%%%%%%%%%%%%%%%%%%%%%%%%%%%%%%%%%%%%%%%%%%%%%%%%%%%%%
%%%%%%%%%%%%%%%%%%%%%%%%%%%%%%%%%%%%%%%%%%%%%%%%%%%%%
#
%%%%%%%%%%%%%%%%%%%%%%%%%%%%%%%%%%%%%%%%%%%%%%%%%%%%%
%%%%%%%%%%%%%%%%%%%%%%%%%%%%%%%%%%%%%%%%%%%%%%%%%%%%%
%%%%%%%%%%%%%%%%%%%%%%%%%%%%%%%%%%%%%%%%%%%%%%%%%%%%%
%%%%%%%%%%%%%%%%%%%%%%%%%%%%%%%%%%%%%%%%%%%%%%%%%%%%%
%%%%%%%%%%%%%%%%%%%%%%%%%%%%%%%%%%%%%%%%%%%%%%%%%%%%%
%%%%%%%%%%%%%%%%%%%%%%%%%%%%%%%%%%%%%%%%%%%%%%%%%%%%%
%% %%%%%%%%%%%%%%%%%%%%%%%%%%%%%%%%%%%%%%%%%%%%%   %%
%% %%%%%%%%%%%%%%%%%%%%%%%%%%%%%%%%%%%%%%%%%%%%%   %%
%% %%%%%%%%%%%%%%%%%%%%%%%%%%%%%%%%%%%%%%%%%%%%%%  %%
%% %%%%%%%%%%%%%%%%%%%%%%%%%%%%%%%%%%%%%%%%%%%%%%  %%
%% %%%%%%%%%%%%%%%%%%%%%%%%%%%%%%%%%%%%%%%%%%%%%%  %%
%% %%%%%%%%%%%%%%%%%%%%%%%%%%%%%%%%%%%%%%%%%%%%%%% %%
%% %%%%%%%%%%%%%%%%%%%%%%%%%%%%%%%%%%%%%   %%%%%%% %%
%% %%%%%%%%%%%%%%%%%%%%%%%%%%%%%%%%%%%%%    %%%%%%%%%
%% %%%%%%%%%%%%%%%%%%%%%%%%%%%%%%%%%%%%%%   %%%%%%%%%
%% %%%%%%%%%%%%%%%%%%%%%%%%%%%%%%%%%%%%%%   %%%%%%%%%
%% %%%%%%%%%%%%%%%%%%%%%         %%%%%%%%%   %%%%%%%%
%%       %%%%%%%%%%%%%%%%%%%%%%%%%%%%%%%%%   %%%%%%%%
%%       %%%%%%%%%%%%%%%%%%%%%%%%%%%%%%%%%    %%%%%%%
%%       %%%%%%%%%%%%%%%%%%%%%%%%%%%%%%%%%    %%%%%%%
%%       %%%%%%%%%%%%%%%%%%%%%%%%%%%%%%%%%    %%%%%%%
%%       %%%%%%%%%%%%%%%%%%%%%%%%%%%%%%%%%     %%%%%%
%%       %%%%%%%%%%%%%%%%%%%%%%%%%%%%%%%%%     %%%%%%
%%       %%%%%%%%%%%%%%%%%%%%%%%%%%%%%%%%%     %%%%%%
%%       %%%%%%%%%%%%%%%%%%%%%%%%%%%%%%%%%    %%%%%%%
%%       %%%%%%%%%%%%%%%%%%%%%%%%%%%%%%%%%   %%%%%%%%
%%       %%%%%%%%%%%%%%%%%%%%%%%%%%%%%%%%%  %%%%%%%%%
%%       %%%%%%%%%%%%%%%%%%%%%%%%%%%%%%%%% %%%%%%%%%%
%%       %%%%%%%%%%%%%%%%%%%%%%%%%%%%%%%%% %%%%%%%%%%
%%        %%%%%%%%%%%%%%%%%%%%%%%%%%%%%%%% %%%%%%%%%%
%%            %%%%%%%%%%%%%%%%%%%%%%%%%%%% %%%%%%%%%%
%%           %%%%%%%%%%%%%%%%%%%%%%%%%%%%% %%%%%%%%%%
%%          %%%%%%%%%%%%%%%%%%%%%%%%%%%%%% %%%%%%%%%%
%%         %%%%%%%%%%%%%%%%%%%%%%%%%%%%%%% %%%%%%% %%
%%        %%%%%%%%%%%%%%%%%%%%%%%%%%%%%%%% %%%%%%  %%
%%       %%%%%%%%%%%%%%%%%%%%%%%%%%%%%%%%%%%%%%%   %%
%%       %%%%%%%%%%%%%%%%%%%%%%%%%%%%%%%%%%%%%%    %%
%%%%%%%%%%%%%%%%%%%%%%%%%%%%%%%%%%%%%%%%%%%%%%%%%%%%%
%%%%%%%%%%%%%%%%%%%%%%%%%%%%%%%%%%%%%%%%%%%%%%%%%%%%%
%%%%%%%%%%%%%%%%%%%%%%%%%%%%%%%%%%%%%%%%%%%%%%%%%%%%%
%%%%%%%%%%%%%%%%%%%%%%%%%%%%%%%%%%%%%%%%%%%%%%%%%%%%%
%%%%%%%%%%%%%%%%%%%%%%%%%%%%%%%%%%%%%%%%%%%%%%%%%%%%%
%%%%%%%%%%%%%%%%%%%%%%%%%%%%%%%%%%%%%%%%%%%%%%%%%%%%%
#
