%%%%%%%%%%%%%%%%%%%%%%%%%%%%%%%%%%%%%%%%%%%%%%%%%%%%%%%%%%%%%%%%%%%%%%%%%
%%%%%%%%%%%%%%%%%%%%%%%%%%%%%%%%%%%%%%%%%%%%%%%%%%%%%%%%%%%%%%%%%%%%%%%%%
%%%%%%%%%%%%%%%%%%%%%%%%%%%                                        %%%%%%
%%%%%%%%%%%%%%%%%%%%%%%%%%%%                                       %%%%%%
%%%%%%%%%%      %%%%%%%%%%%%%                                      %%%%%%
%%%%%%%%%%       %%%%%%%%%%%%%%%%%%%%%%%%%%%%%%%%%                 %%%%%%
%%%%%%%%%%        %%%%%%%%%%%%%%%%%%%%%%%%%%%%%%%%%                %%%%%%
%%%%%%%%%%         %%%%%%%%%%%%%%%%%%%%%%%%%%%%%%%%                %%%%%%
%%%%%%%%%%                             %%%%%%%%%%%%%               %%%%%%
%%%%%%%%%%                              %%%%%%%%%%%%               %%%%%%
%%%%%%%%%%                              %%%%%%%%%%%%%              %%%%%%
%%%%%%%%%%                               %%%%%%%%%%%%              %%%%%%
%%%%%%%%%%         %%%%%%%%%%%%%%%%%%%%% %%%%%%%%%%%%%             %%%%%%
%%%%%%%%%%       %%%%%%%%%%%%%%%%%%%%%%%  %%%%%%%%%%%%             %%%%%%
%%%%%%%%%%      %%%%%%%%%%%%%%%%%%%%%%%%% %%%%%%%%%%%%%            %%%%%%
%%%%%%%%%%%%%%%%%%%%%%%%%%%%%%%%%%%%%%%%%  %%%%%%%%%%%%            %%%%%%
%%%%%%%%%%%%%%%%%%%%%%%%%%%%  %%%%%%%%%%%% %%%%%%%%%%%%%           %%%%%%
%%%%%%%%%%%%%%%%%%%%%%%%%%   %%%%%%%%%%%%%  %%%%%%%%%%%%           %%%%%%
%%%%%%                  %%%%%%%%%%%%%%%%%%  %%%%%%%%%%%%%          %%%%%%
%%%%%%              %%%%%%%%%%%%%%%%%%%%%%   %%%%%%%%%%%%          %%%%%%
%%%%%%          %%%%%%%%%%%%%%%%%%%%%%%%     %%%%%%%%%%%%%         %%%%%%
%%%%%%     %%%%%%%%%%%%%%%%%%%%%%%%%          %%%%%%%%%%%%%%%%%%%%%%%%%%%
%%%%%% %%%%%%%%%%%%%%%%%%%%%%%%               %%%%%%%%%%%%%%%%%%%%%%%%%%%
%%%%%%%%%%%%%%%%%%%%%%%%%%%%%%%%%%%%%%%%%%%%%% %%%%%%%%%%%%%%%%%%%%%%%%%%
%%%%%%%%%%%%%%%%%%%%%%%%%%%%%%%%%%%%%%%%%%%%%%            .......%%%%%%%%
%%%%%%%%%%%%%%%%%%%%%%%%%%%%%%%%%%%%%%%%%%%%%%%%%%%%%%%%%%%%%%%%%%%%%%%%%
%%%%%%                             %%%%%%%%%%%%%%%%%%%%%%%%%%%%%%%%%%%%%%
%%%%%%                             %%%%%%%%%%%%%%%%%%%%%%%%%%%%%%%%%%%%%%
%%%%%%                             %%%%%%%%%%%%%%%%%%%%%           %%%%%%
%%%%%%         %%%%%%%%%%%%%%%%%%%%%%%%%%%%%%%%%%%%%%%%            %%%%%%
%%%%%%        %%%%%%%%%%%%%%%%%%%%%%%%%%%%%%%%%%%%%%%%%            %%%%%%
%%%%%%       %%%%%%%%%%%%%%%%%%%%%%%%%%%%%%%%%%%%%%%%%%            %%%%%%
%%%%%%      %%%%%%%%%%%%%                  %%%%%%%%%%%             %%%%%%
%%%%%%     %%%%%%%%%%%%%                   %%%%%%%%%%%             %%%%%%
%%%%%%    %%%%%%%%%%%%%                    %%%%%%%%%%%             %%%%%%
%%%%%%   %%%%%%%%%%%%%                     %%%%%%%%%%%             %%%%%%
%%%%%%  %%%%%%%%%%%%%                      %%%%%%%%%%%             %%%%%%
%%%%%% %%%%%%%%%%%%%                       %%%%%%%%%%%             %%%%%%
%%%%%%%%%%%%%%%%%%%                        %%%%%%%%%%%             %%%%%%
%%%%%%%%%%%%%%%%%%%%%%%%%%%%%%%%%%%%%%%%%%%%%%%%%%%%%%             %%%%%%
%%%%%%%%%%%%%%%%%%%%%%%%%%%%%%%%%%%%%%%%%%%%%%%%%%%%%%             %%%%%%
%%%%%%%%%%%%%%%%%%%%%%%%%%%%%%%%%%%%%%%%%%%%%%%%%%%%%%             %%%%%%
%%%%%%                             %%%%%%%%%%%%%%%%%%%             %%%%%%
%%%%%%                             %%%%%%%%%%%%%%%%%%%%%%%%%%%%%%% %%%%%%
%%%%%%                             %%%%%%%%%%%%%%%%%%%%%%%%%%%%%%% %%%%%%
%%%%%%                             %%%%%%%%%%%%%%%%%%%%%%%%%%%%%%% %%%%%%
%%%%%%                             %%%%%%%%%%%         %%%%%%%%%%% %%%%%%
%%%%%%                             %%%%%%%%%%%         %%%%%%%%%%% %%%%%%
%%%%%%                             %%%%%%%%%%%.........%%%%%%%%%%% %%%%%%
%%%%%%                             %%%%%%%%%%%.........%%%%%%%%%%% %%%%%%
%%%%%%                             %%%%%%%%%%%.........%%%%%%%%%%% %%%%%%
%%%%%%                             %%%%%%%%%%%%%%%%%%%%%%%%%%%%%%% %%%%%%
%%%%%%                             %%%%%%%%%%%%%%%%%%%%%%%%%%%%%%% %%%%%%
%%%%%%%%%%%%%%%%%%%%%%%%%%%%%%%%%%%%%%%%%%%%%%%%%%%%%%%%%%%%%%%%%%%%%%%%%
%%%%%%%%%%%%%%%%%%%%%%%%%%%%%%%%%%%%%%%%%%%%%%%%%%%%%%%%%%%%%%%%%%%%%%%%%
#
%%%%%%%%%%%%%%%%%%%%%%%%%%%%%%%%%%%%%%%%%%%%%%%%%%%%%%%%%%%%%%%%%%%%%%%%%
%%%%%%%%%%%%%%%%%%%%%%%%%%%%%%%%%%%%%%%%%%%%%%%%%%%%%%%%%%%%%%%%%%%%%%%%%
%%%%%%%%%%%%%%%%%%%%%%%%%%%%%%%%%%%%%%%%%%%%%%%%%%%%%%%%%%%%%%%%%%%%%%%%%
%%%%%%%%%%%%%%%%%%%%%%%%%%%%%%%%%%%%%%%%%%%%%%%%%%%%%%%%%%%%%%%%%%%%%%%%%
%%%%%%%%%%%%%%%%%%%%%%%%%%%%%%%%%%%%%%%%%%%%%%%                      %%%%
%%%%%%%%%%%%%%%%%%%%%%%%%%%%%%%%%%%%%%%%%%%%%%%%                     %%%%
%%%%%%%%            %%%%%%%%%%%%%%%%%%%%%%%%%%%%                     %%%%
%%%%%%%%             %%%%%%%%%%%%%%%%%%%%%%%%%%%%                    %%%%
%%%%%%%%P             %%%%%%%%%%%%%%%%%%%%%%%%%%%                    %%%%
%%%%%%%%               %%%%%%%%%%%%%%%%%%%%%%%%%%%                   %%%%
%%%%%%%%               %%%%%%%%%%%%%       %%%%%%%                   %%%%
%%%%%%%%              %%%%%%%%%%%%%%%      %%%%%%%%                  %%%%
%%%%%%%%            %%%%%%%%%%%%%%%%%%      %%%%%%%                  %%%%
%%%%%%%%%%%%%%%%%%%%%%%%%%%%%%%%%%%%%%      %%%%%%%%                 %%%%
%%%%%%%%%%%%%%%%%%%%%%%%%%%%%%%%%%%%%%       %%%%%%%                 %%%%
%%%%%%%%%%%%%%%%%%%%%%%%%%%%%%%%%%%%%%%      %%%%%%%%                %%%%
%%%%%%%%%%%%%%%%%%%%%%%%%%%%%%%%%%%%%%%       %%%%%%%                %%%%
%%%%%%%%%%%%%%%%%%%%%%%%%  %%%%%%%%%%%%%      %%%%%%%%               %%%%
%%%%%%%%%%%%%%%%%%%%%%%%%%%%%%%%%%%%%%%%       %%%%%%%               %%%%
%%%%%%%%%%%%%%%%%%%%%%%%%%%%%%%%%%%%%%%%       %%%%%%%%%%%%%%%%%%%%%%%%%%
%%%%          %%%%%%%%%%%%%%%%%%%%%%%%%         %%%%%%%%%%%%%%%%%%%%%%%%%
%%%%      %%%%%%%%%%%%%%%%%%%%%%%%%%%%%%%%      %%%%%%%%%%%%%%%%%%%%%%%%%
%%%%      %%%%%%%%%%%%%%%%%%%%%%%%%%%%%%%%%      %%%%%%%%%%%%%%%%%%%%%%%%
%%%%      %%%%%%%%%%%%%%%%%%%%%%%%%%%%%%%%%%     %%%%%%%%%%%%%%%%%%%%%%%%
%%%%      %%%%%%%%%%%%%%%%%%%%%%%%%%%%%%%%%%    %%%%%%%%%%%%%%%%%%%%%%%%%
%%%%      %%%%%%%%%%%%%%%%%%%%%%%%%%%%%%%%%%   %%%%%%%%%%%%%%%%%%%%%%%%%%
%%%%      %%%%%%%%%%%%%%%%%%%%%%%%%%%%%%%%%%   %%%%%%%%%%%%%%%%%%%%%%%%%%
%%%%      %%%%%%%%%%%%%%%%%%%%%%%%%%%%%%%%%%   %%%%%%%%%%%%%%%%%%%%%%%%%%
%%%%              %%%%%%%%%%%%%%%%%%%%%%%%%%  %%%%%%%%%%%%%%%%%%%%%%%%%%%
%%%%             %%%%%%%%%%%%%%%%%%%%%%%%%%%  %%%%%%%%%%%%%%%%%%%%%%%%%%%
%%%%            %%%%%%%%%%%%%%%%%%%%%%%%%%%%  %%%%%%%                %%%%
%%%%           %%%%%%%%%%%%%%%%%%%%%%%%%%%%% %%%%%%%                 %%%%
%%%%          %%%%%%%%%%%%%%%%%%%%%%%%%%%%%  %%%%%%%                 %%%%
%%%%         %%%%%%%%%%%%%%%%%%%%%%%%%%%%%   %%%%%%%                 %%%%
%%%%        %%%%%%%%%                        %%%%%%%                 %%%%
%%%%       %%%%%%%%%                         %%%%%%%                 %%%%
%%%%      %%%%%%%%%                          %%%%%%%                 %%%%
%%%%     %%%%%%%%%%%%%%%%%%%%%%%%%%%%%%%%%   %%%%%%%                 %%%%
%%%%    %%%%%%%%%%%%%%%%%%%%%%%%%%%%%%%%%%%  %%%%%%%                 %%%%
%%%%     %%%%%%%%%%%%%%%%%%%%%%%%%%%%%%%%%%% %%%%%%%                 %%%%
%%%%      %%%%%%%%%%%%%%%%%%%%%%%%%%%%%%%%%% %%%%%%%                 %%%%
%%%%      %%%%%%%%%%%%%%%%%%%%%%%%%%%%%%%%%% %%%%%%%%%%%%%%%%%       %%%%
%%%%      %%%%%%%%%%%%%%%%%%%%%%%%%%%%%%%%%% %%%%%%%%%%%%%%%%%%      %%%%
%%%%      %%%%%%%%%%%%%%%%%%%%%%%%%%%%%%%%%% %%%%%%%%%%%%%%%%%%%     %%%%
%%%%                                 %%%%%%% %%%%%%%%%%%%%%%%%%%     %%%%
%%%%                                 %%%%%%% %%%%%%%%%%%%%%%%%%%     %%%%
%%%%                                 %%%%%%%  %%%%%%%%%%%%%%%%%%     %%%%
%%%%                                 %%%%%%%   %%%%%%%%%%%%%%%%%     %%%%
%%%%                                 %%%%%%%    .....    %%%%%%%     %%%%
%%%%                                 %%%%%%%%%%%%%%%%%%%%%%%%%%%     %%%%
%%%%                                 %%%%%%%%%%%%%%%%%%%%%%%%%%%     %%%%
%%%%%%%%%%%%%%%%%%%%%%%%%%%%%%%%%%%%%%%%%%%%%%%%%%%%%%%%%%%%%%%%%%%%%%%%%
%%%%%%%%%%%%%%%%%%%%%%%%%%%%%%%%%%%%%%%%%%%%%%%%%%%%%%%%%%%%%%%%%%%%%%%%%
%%%%%%%%%%%%%%%%%%%%%%%%%%%%%%%%%%%%%%%%%%%%%%%%%%%%%%%%%%%%%%%%%%%%%%%%%
%%%%%%%%%%%%%%%%%%%%%%%%%%%%%%%%%%%%%%%%%%%%%%%%%%%%%%%%%%%%%%%%%%%%%%%%%
#
%%%%%%%%%%%%%%%%%%%%%%%%%%%%%%%%%%%%%%%%%%%%%%%%%%%%%%%%%%%%%%%%%%%%%%%%%
%%%%%%%%%%%%%%%%%%%%%%%%%%%%%%%%%%%%%%%%%%%%%%%%%%%%%%%%%%%%%%%%%%%%%%%%%
%%%%%%%%%%%%%%%%%%%%%%%%%%%%%%%%%%%%%%%%%%%%%%%%%%%%%%%%%%%%%%%%%%%%%%%%%
%%%%%%%%%%%%%%%%%%%%%%%%%%%%%%%%%%%%%%%%%%%%%%%%%%%%%%%%%%%%%%%%%%%%%%%%%
%%%%%%%%%%%%%%%%%%%%%%%%%%%%%%%%%%%%%%%%%%%%%%%%%%%%%%%%%%%%%%%%%%%%%%%%%
%%%%%%%%%%%%%%%%%%%%%%%%%%%%%%%%%%%%%%%%%%%%%%%%%%%%%%%%%%%%%%%%%%%%%%%%%
%% %%%%%%%%%%%%%%%%%%%%%%%%%%%%%%%%%%%%%%%%%%%%%%                      %%
%% %%%%%%%%%%%%%%%%%%%%%%%%%%%%%%%%%%%%%%%%%%%%%%                      %%
%% %%%              %%%%%%%%%%%%%%%%%%%%%%%%%%%%%%                     %%
%% %%%               %%%%%%%%%%%%%%%%%%%%%%%%%%%%%                     %%
%% %%%              %%%%%%%%%%%%%%%%%%%%%%%%%%%%%%%                    %%
%% %%%%%%%%%%%%%%%%%%%%%%%%%%%%%%%%%%%%%%%%%%%%%%%%                    %%
%% %%%%%%%%%%%%%%%%%%%%%%%%%%%%%%%%%%%     %%%%%%%%%                   %%
%% %%%%%%%%%%%%%%%%%%%%%%%%%%%%%%%%%%%      %%%%%%%%                   %%
%% %%%%%%%%%%%%%%%%%%%%%%%%%%%%%%%%%%%      %%%%%%%%%                  %%
%% %%%%%%%%%%%%%%%%%%%%%%%%%%%%%%%%%%%       %%%%%%%%                  %%
%% %%%%%%%%%%%%%%%%%%%%%%%%%%%%%%%%%%%       %%%%%%%%%                 %%
%% %%%%%%%%%%%%%%%%%%%%%%%%%%%%%%%%%%%        %%%%%%%%%%%%%%%%%%%%%%%%%%%
%% %%%%%%%%%%%%%%%%%%%%%%%%%%%%%%%%%%%        %%%%%%%%%%%%%%%%%%%%%%%%%%%
%% %%%%%%%%%%%%%%%%%%%%%%%%%%%%%%%%%%%%%%%     %%%%%%%%%%%%%%%%%%%%%%%%%%
%% %%%%%%%%%%%%%%%%%%%%%%%%%%%%%%%%%%%%%%%     %%%%%%%%%%%%%%%%%%%%%%%%%%
%% %%%%%%%%%%%%%%%%%%%%%%%%%%%%%%%%%%%%%%%      %%%%%%%%%%%%%%%%%%%%%%%%%
%%        %%%%%%%%%%%%%%%%%%%%%%%%%%%%%%%%      %%%%%%%%%%%%%%%%%%%%%%%%%
%%        %%%%%%%%%%%%%%%%%%%%%%%%%%%%%%%%      %%%%%%%%%%%%%%%%%%%%%%%%%
%%        %%%%%%%%%%%%%%%%%%%%%%%%%%%%%%%%      %%%%%%%%%%%%%%%%%%%%%%%%%
%%        %%%%%%%%%%%%%%%%%%%%%%%%%%%%%%%%      %%%%%%%%%%%%%%%%%%%%%%%%%
%%        %%%%%%%%%%%%%%%%%%%%%%%%%%%%%%%%     %%%%%%%%%%%%%%%%%%%%%%%%%%
%%        %%%%%%%%%%%%%%%%%%%%%%%%%%%%%%%%     %%%%%%%%%%%%%%%%%%%%%%%%%%
%%        %%%%%%%%%%%%%%%%%%%%%%%%%%%%%%%%     %%%%%%%%%%%%%%%%%%%%%%%%%%
%%        %%%%%%%%%%%%%%%%%%%%%%%%%%%%%%%%     %%%%%%%%%%%%%%%%%%%%%%%%%%
%%            %%%%%%%%%%%%%%%%%%%%%%%%%%%%     %%%%%%%%%%%%%%%%%%%%%%%%%%
%%           %%%%%%%%%%%%%%%%%%%%%%%%%%%%%     %%%%%%%%%%%%%%%%%%%%%%%%%%
%%          %%%%%%%%%%%%%%%%%%%%%%%%%%%%%%     %%%%%                   %%
%%         %%%%%%%%%%%%%%%%%%%%%%%%%%%%%%%     %%%%                    %%
%%        %%%%%%%%%%%%%%%%%%%%%%%%%%%%%%%%     %%%%                    %%
%%       %%%%%%%%%%%%%%%%%%%%%%%%%%%%%%%%%     %%%%                    %%
%%       %%%%%%%%%%%%%%%%%%%%%%%%%%%%%%%%%     %%%                     %%
%%       %%%%%%%%%%%%%%%%%%%%%%%%%%%%%%%%%     %%%                     %%
%%       %%%%%%%%%%%%%%%%%%%%%%%%%%%%%%%%%     %%%                     %%
%%       %%%%%%%%%%%%%%%%%%%%%%%%%%%%%%%%%     %%%%%%%%%%%%%%%         %%
%%       %%%%%%%%%%%%%%%%%%%%%%%%%%%%%%%%%     %%%%%%%%%%%%%%%         %%
%%       %%%%%%%%%%%%%%%%%%%%%%%%%%%%%%%%%     %%%%%%%%%%%%%%%         %%
%%       %%%%%%%%%%%%%%%%%%%%%%%%%%%%%%%%%     %%%%%%%%%%%%%%%         %%
%%       %%%%%%%%%%%%%%%%%%%%%%%%%%%%%%%%%     %%%%%%%%%%%%%%%         %%
%%        %%%%%%%%%%%%%%%%%%%%%%%%%%%%%%%%     %%%%%%%%%%%%%%%         %%
%%        %%%%%%%%%%%%%%%%%%%%%%%%%%%%%%%%     %%%%%%%%%%%%%%%         %%
%%                                     %%%     %%%%%%%%%%%%%%%         %%
%%                                     %%%%%%%%%%%%%%%%%%%%%%%         %%
%%                                     %%%%%%%%%%%%%%%%%%%%%%%         %%
%%%%%%%%%%%%%%%%%%%%%%%%%%%%%%%%%%%%%%%%%%%%%%%%%%%%%%%%%%%%%%%%%%%%%%%%%
%%%%%%%%%%%%%%%%%%%%%%%%%%%%%%%%%%%%%%%%%%%%%%%%%%%%%%%%%%%%%%%%%%%%%%%%%
%%%%%%%%%%%%%%%%%%%%%%%%%%%%%%%%%%%%%%%%%%%%%%%%%%%%%%%%%%%%%%%%%%%%%%%%%
%%%%%%%%%%%%%%%%%%%%%%%%%%%%%%%%%%%%%%%%%%%%%%%%%%%%%%%%%%%%%%%%%%%%%%%%%
%%%%%%%%%%%%%%%%%%%%%%%%%%%%%%%%%%%%%%%%%%%%%%%%%%%%%%%%%%%%%%%%%%%%%%%%%
%%%%%%%%%%%%%%%%%%%%%%%%%%%%%%%%%%%%%%%%%%%%%%%%%%%%%%%%%%%%%%%%%%%%%%%%%
#
