%%%%%%%%%%%%%%%%%%%%%%%
%%%%%%%%%%%%%%%%%%%%%%%
%%%%   %%%%%%%%%%%%%%%%
%%%%  %%%%%%%%%%% %%%%%
%%%%  %%%%%%%.    %%%%%
%%%%  %%%%%%%%%%% %%%%%
%%%%  %%%%%%%%%%%%%%%%%
%%%%       %%%%%%%%%%%%
%%%%%%%%%%%%%%%%%%%%%%%
%%%%%%%%%%%%%%%%%%%%%%%
%%%%%%%%%%%%%%%%%%%%%%%
%%%%      %%%%%%%%%%%%%
%%%%              %%%%%
%%%%       %%%%%%%%%%%%
%%%%%%%%%%%%%%%%%%%%%%%
%%%%%%%%%%%%%%%%%%%%%%%
%%%%%%%%%%%%%%     %%%%
%%%%               %%%%
%%%%               %%%%
%%%%%%%%%%%%%%%%%%%%%%%
%%%%%%%%%%%%%%%%%%%%%%%
#
%%%%%%%%%%%%%%%%%%%%%%%
%%%%%%%%%%%%%%%%%%%%%%%
%%       %%%%%%%%%%%%%%
%%      %%%%%%%%    %%%
%%      %%%%%%%     %%%
%%      %%%%%%%%    %%%
%%      %%%%%%%%%%%%%%%
%%      %%%%%%%%%%%%%%%
%%%%%%%%%%%%%%%%%%%%%%%
%%%%%%%%%%%%%%%%%%% %%%
%%%%%%%%%%%%%%%%%%  %%%
%%        %%%%%%%   %%%
%% P         %%%    %%%
%%        %%%%%%%%%%%%%
%%%%%%%%%%%%%%%%%%%%%%%
%%%%%%%%%%%%%%%%%%%%%%%
%%%%%%%%%%%%%%%      %%
%%                   %%
%%                   %%
%%%%%%%%%%%%%%%%%%%%%%%
%%%%%%%%%%%%%%%%%%%%%%%
#
%%%%%%%%%%%%%%%%%%%%%%%
%%%%%%%%%%%%%%%%%%%%%%%
%%%%%%%%%%%%%%%%%%%%%%%
%%%%%%%%%%%%%%%%%%%%%%%
%%      %%%%%%%%%%%%%%%
%%      %%%%%%%%%%% %%%
%%%%%%%%%%%%%%%%%%% %%%
%%%%%%%%%%%%%%%%%%% %%%
%%%%%%%%%%%%%%%%%%% %%%
%%%%%%%%%%%%%%%%%%% %%%
%%%%%%%%%%%%%%%%%%% %%%
%%%%%%%%%%%%%%%%%%%%%%%
%%%%%%%%%%%%%%%%%%%%%%%
%%%%%%%%%%%%%%%%%%%%%%%
%%%%%%%%%%%%%%%%%%%%%%%
%%%%%%%%%%%%%%%%%%%%%%%
%%%%%%%%%%%%%%%%%%%%%%%
%%%%%%%%%%%%%%%%%%%%%%%
%%%%%%%%%%%%%%%%%%%%%%%
%%%%%%%%%%%%%%%%%%%%%%%
%%%%%%%%%%%%%%%%%%%%%%%
#
