%%%%%%%%%%%%%%%%%%%%%%%%%%%%%%%%%%%%%
%%%%%%%%%%%%%%%%%%%%%%%%%%%%%%%%%%%%%
%%%%%%%%%%%%%%%%%%%%%%%%%        %%%%
%%%%%%   %%%%%%%%%%%%%%%%%       %%%%
%%%%%%    %%%%%%%%%%%%%%%%       %%%%
%%%%%%              %%%%%%%      %%%%
%%%%%%   %%%%%%%%%%%%%%%%%%      %%%%
%%%%%%%%%%%%%%%%%%%%%%%%%%%%     %%%%
%%%%%%%%%%%%%%%%%%%%% %%%%%%     %%%%
%%%%%%%%%%%%%%%%%%%%%%%%%%%%%    %%%%
%%%%   %%%%%%%%%%%%%%  %%%%%%%%%%%%%%
%%%%%%%%%%%%%%%%%%%%%%%%%%%%%%%%%%%%%
%%%%%%%%%%%%%%%%%%%%%%%%%%%%%%%%%%%%%
%%%%%%%%%%%%%%%%%%%%%%%%%%%%%%%%%%%%%
%%%%    %%%%%%%%%%%%%%%%%%%%%%%%%%%%%
%%%%   %%%%%%%%%%%%%%%%%%%%%     %%%%
%%%%  %%%%%%%%%%%%%%%%%%%%%%     %%%%
%%%% %%%%%%%         %%%%%%%     %%%%
%%%%%%%%%%%          %%%%%%%     %%%%
%%%%%%%%%%%%%%%%%%%%%%%%%%%%     %%%%
%%%%%%%%%%%%%%%%%%%%%%%%%%%%     %%%%
%%%%%%%%%%%%%%%%%%%%%%%%%%%%%%%%%%%%%
%%%%             %%%%%%%%%%%%%%%%%%%%
%%%%             %%%%%%%%%%%%%%%%%%%%
%%%%             %%%%%%%...%%%%%%%%%%
%%%%             %%%%%%%%%%%%%%%%%%%%
%%%%%%%%%%%%%%%%%%%%%%%%%%%%%%%%%%%%%
%%%%%%%%%%%%%%%%%%%%%%%%%%%%%%%%%%%%%
#
%%%%%%%%%%%%%%%%%%%%%%%%%%%%%%%%%%%%%
%%%%%%%%%%%%%%%%%%%%%%%%%%%%%%%%%%%%%
%%%%%%%%%%%%%%%%%%%%%%%%           %%
%%%%      %%%%%%%%%%%%%%%          %%
%%%%P      %%%%%%%%%%%%%%          %%
%%%%       %%%%%%%%  %%%%%         %%
%%%%      %%%%%%%%%   %%%%         %%
%%%%%%%%%%%%%%%%%%%%  %%%%%        %%
%%%%%%%%%%%%%%%%%%%%   %%%%        %%
%%%%%%%%%%%%%%%%%%%%   %%%%%       %%
%%   %%%%%%%%%%%%%%%    %%%%%%%%%%%%%
%%   %%%%%%%%%%%%%%%%%  %%%%%%%%%%%%%
%%   %%%%%%%%%%%%%%%%%  %%%%%%%%%%%%%
%%   %%%%%%%%%%%%%%%%% %%%%%%%%%%%%%%
%%       %%%%%%%%%%%%% %%%%%%%%%%%%%%
%%      %%%%%%%%%%%%%% %%%%        %%
%%     %%%%%%%%%%%%%%% %%%%        %%
%%    %%%%%            %%%         %%
%%   %%%%%             %%%         %%
%%  %%%%%%%%%%%%%%%%%% %%%         %%
%%   %%%%%%%%%%%%%%%%% %%%         %%
%%   %%%%%%%%%%%%%%%%% %%%%%%%%%   %%
%%                 %%% %%%%%%%%%   %%
%%                 %%% %%%%%%%%%   %%
%%                 %%%  ...  %%%   %%
%%                 %%%%%%%%%%%%%   %%
%%%%%%%%%%%%%%%%%%%%%%%%%%%%%%%%%%%%%
%%%%%%%%%%%%%%%%%%%%%%%%%%%%%%%%%%%%%
#
%%%%%%%%%%%%%%%%%%%%%%%%%%%%%%%%%%%%%
%%%%%%%%%%%%%%%%%%%%%%%%%%%%%%%%%%%%%
%%%%%%%%%%%%%%%%%%%%%%%%%%%%%%%%%%%%%
%%%%%%%%%%%%%%%%%%%%%%%%%%%%%%%%%%%%%
%%%%%%%%%%%%%%%%%%%%%%%%%          %%
%%%%%%%%%%%%%%%%%%%%%%%%%%         %%
%%%%%%%%%%%%%%%%%%%%%%%%%%         %%
%%%%%%%%%%%%%%%%%%%%  %%%%%        %%
%%%%%%%%%%%%%%%%%%%%   %%%%%%%%%%%%%%
%%%%%%%%%%%%%%%%%%%%%  %%%%%%%%%%%%%%
%%%%%%%%%%%%%%%%%%%%%%  %%%%%%%%%%%%%
%%%%%%%%%%%%%%%%%%%%%%  %%%%%%%%%%%%%
%%   %%%%%%%%%%%%%%%%%  %%%%%%%%%%%%%
%%   %%%%%%%%%%%%%%%%%  %%%%%%%%%%%%%
%%   %%%%%%%%%%%%%%%%% %%%%%%%%%%%%%%
%%   %%%%%%%%%%%%%%%%% %%%%%%%%%%%%%%
%%    %%%%%%%%%%%%%%%% %%%%%%%%%%%%%%
%%   %%%%%%%%%%%%%%%%% %%%         %%
%%   %%%%%%%%%%%%%%%%% %%%         %%
%%   %%%%%%%%%%%%%%%%% %%%%%%%%    %%
%%   %%%%%%%%%%%%%%%%% %%%%%%%%%   %%
%%   %%%%%%%%%%%%%%%%% %%%%%%%%%   %%
%%   %%%%%%%%%%%%%%%%% %%%%%%%%%   %%
%%   %%%%%%%%%%%%%%%%%%%%%%%%%%%   %%
%%%%%%%%%%%%%%%%%%%%%%%%%%%%%%%%%%%%%
%%%%%%%%%%%%%%%%%%%%%%%%%%%%%%%%%%%%%
%%%%%%%%%%%%%%%%%%%%%%%%%%%%%%%%%%%%%
%%%%%%%%%%%%%%%%%%%%%%%%%%%%%%%%%%%%%
#
