%%%%%%%%%%%%%%%%%%%%%%%%%%%%%%%%%%%%%%%%%%%%%
%%%%%%%%%%%%%%%%%%%%%%%%%%%%%%%%%%%%%%%%%%%%%
%%%%%%                %%%%%%%%%%%%%%%%%%%%%%%
%%%%%%                %%%%%%%%%%%%%%%%%%%%%%%
%%%%%%        %%%%%%%%%%%%%%%%%%%    %%%%%%%%
%%%%%%       %%%%%%%%%%%%%%%%%%%%    %%%%%%%%
%%%%%%       %%%%%%%%%%%%%%%%%%%     %%%%%%%%
%%%%%%       %%%%%%%%%%%...          %%%%%%%%
%%%%%%       %%%%%%%%%%%...          %%%%%%%%
%%%%%%       %%%%%%%%%%%...          %%%%%%%%
%%%%%%       %%%%%%%%%%%%%%%%%%%     %%%%%%%%
%%%%%%       %%%%%%%%%%%%%%%%%%%%    %%%%%%%%
%%%%%%       %%%%%%%%%%%%%%%%%%%%    %%%%%%%%
%%%%%%                %%%%%%%%%%%%%%%%%%%%%%%
%%%%%%                %%%%%%%%%%%%%%%%%%%%%%%
%%%%%%                 %%%%%%%%%%%%%%%%%%%%%%
%%%%%%                     %%%%%%%%%%%%%%%%%%
%%%%%%%%%%%%%%%%%%%%%%%%%%%%%%%%%%%%%%%%%%%%%
%%%%%%%%%%%%%%%%%%%%%%%%%%%%%%%%%%%%%%%%%%%%%
%%%%%%%%%%%%%%%%%%%%%%%%%%%%%%%%%%%%%%%%%%%%%
%%%%%%           %%%%%%%%%%%%%%%%%%% %%%%%%%%
%%%%%%             %%%%%%%%%%%%%%%%  %%%%%%%%
%%%%%%                %%%%%%%%%%%%   %%%%%%%%
%%%%%%                               %%%%%%%%
%%%%%%                               %%%%%%%%
%%%%%%                               %%%%%%%%
%%%%%%                               %%%%%%%%
%%%%%%               %%%%%%%%%%%%%%%%%%%%%%%%
%%%%%%           %%%%%%%%%%%%%%%%%%%%%%%%%%%%
%%%%%%%%%%%%%%%%%%%%%%%%%%%%%%%%%%%%%%%%%%%%%
%%%%%%%%%%%%%%%%%%%%%%%%%%%%%%%%       %%%%%%
%%%%%%%%%%%%%%%%%%%%%%%%%%%%           %%%%%%
%%%%%%                                 %%%%%%
%%%%%%                                 %%%%%%
%%%%%%                                 %%%%%%
%%%%%%                                 %%%%%%
%%%%%%                                 %%%%%%
%%%%%%                                 %%%%%%
%%%%%%                                 %%%%%%
%%%%%%%%%%%%%%%%%%%%%%%%%%%%%%%%%%%%%%%%%%%%%
%%%%%%%%%%%%%%%%%%%%%%%%%%%%%%%%%%%%%%%%%%%%%
#
%%%%%%%%%%%%%%%%%%%%%%%%%%%%%%%%%%%%%%%%%%%%%
%%%%%%%%%%%%%%%%%%%%%%%%%%%%%%%%%%%%%%%%%%%%%
%%%%%%%%%%%%%%%%%%%%%%%%%%%%%%%%%%%%%%%%%%%%%
%%%%%%%%%%%%%%%%%%%%%%%%%%%%%%%%%%%%%%%%%%%%%
%%%%              %%%%%%%%%%%%%%%%%%%%%%%%%%%
%%%%           %%%%%%%%%%%%%%%%%%%%%%%%%%%%%%
%%%%           %%%%%%%%%%%%%%%         %%%%%%
%%%%           %%%%%%%%%%%%%%          %%%%%%
%%%%           %%%%%%%%%%%%%           %%%%%%
%%%%           %%%%%%%%%%%%%%          %%%%%%
%%%%           %%%%%%%%%%%%%%%         %%%%%%
%%%%           %%%%%%%%%%%%%%%%%%%%%%  %%%%%%
%%%%           %%%%%%%%%%%%%%%%%%%%%%% %%%%%%
%%%%            %%%%%%%%%%%%%%%%%%%%%%%%%%%%%
%%%%             %%%%%%%%%%%%%%%%%%%%%%%%%%%%
%%%%%%%%%%%%%%%%%%%%%%   %%%%%%%%%%%%%%%%%%%%
%%%%%%%%%%%%%%%%%%%%%%%%  %%%%%%%%%%%% %%%%%%
%%%%%%%%%%%%%%%%%%%%%%%%%%%%%%%%%%%%%  %%%%%%
%%%%%%%%%%%%%%%%%%%%%%%%%%%%%%%%%%%%   %%%%%%
%%%%%%%%%%%%%%%%%%%%%%%%%%%%%%%%%%%    %%%%%%
%%%%%%%%%%%%%%%%%%%%%%%%%%%%%%%%%%     %%%%%%
%%%%%%%%%%%%%%%%%%%%%%%%%%%%%%%%%      %%%%%%
%%%%                  %%%%%%%%%%       %%%%%%
%%%%                     %%%%%%        %%%%%%
%%%%  P                    %%%         %%%%%%
%%%%                       %%%%%%%%%%%%%%%%%%
%%%%                   %%%%%%%%%%%%%%%%%%%%%%
%%%%%%%%%%%%%%%%%%%%%%%%%%%%%%%%%%%%%%%%%%%%%
%%%%%%%%%%%%%%%%%%%%%%%%%%%%%%%%%%%%%%%%%%%%%
%%%%%%%%%%%%%%%%%%%%%%%%%%%%%%%%%%%%%%%%%%%%%
%%%%%%%%%%%%%%%%%%%%%%%%%%%%%%%%%%%%%%%%%%%%%
%%%%%%%%%%%%%%%%%%%%%%%%%%%%%%%%%%%%%%%%%%%%%
%%%%%%%%%%%%%%%%%%%%%%%%%%               %%%%
%%%%%%%%%%%%%%%%%%%%%%                   %%%%
%%%%                                     %%%%
%%%%                                     %%%%
%%%%                                     %%%%
%%%%%%%%%%%%%%%%%%%%%%%%%%%%%%%%%%%%%%%%%%%%%
%%%%%%%%%%%%%%%%%%%%%%%%%%%%%%%%%%%%%%%%%%%%%
%%%%%%%%%%%%%%%%%%%%%%%%%%%%%%%%%%%%%%%%%%%%%
%%%%%%%%%%%%%%%%%%%%%%%%%%%%%%%%%%%%%%%%%%%%%
#
%%%%%%%%%%%%%%%%%%%%%%%%%%%%%%%%%%%%%%%%%%%%%
%%%%%%%%%%%%%%%%%%%%%%%%%%%%%%%%%%%%%%%%%%%%%
%%%%%%%%%%%%%%%%%%%%%%%%%%%%%%%%%%%%%%%%%%%%%
%%%%%%%%%%%%%%%%%%%%%%%%%%%%%%%%%%%%%%%%%%%%%
%%%%%%%%%%%%%%%%%%%%%%%%%%%%%%%%%%%%%%%%%%%%%
%%%%%%%%%%%%%%%%%%%%%%%%%%%%%%%%%%%%%%%%%%%%%
%%               %%%%%%%%%%%%%%%%%%%%%%%%%%%%
%%               %%%%%%%%%%%%%%%%%%%%%%%%%%%%
%%               %%%%%%%%%%%%            %%%%
%%               %%%%%%%%%%%%%%%%%%%%    %%%%
%%               %%%%%%%%%%%%%%%%%%%%    %%%%
%%               %%%%%%%%%%%%%%%%%%%%    %%%%
%%               %%%%%%%%%%%%%%%%%%%%    %%%%
%%%%%%%%%%%%%%%%%%%%%%%%%%%%%%%%%%%%%    %%%%
%%%%%%%%%%%%%%%%%%%%%%%%%%%%%%%%%%%%%    %%%%
%%%%%%%%%%%%%%%%%%%%%%%%%%%%%%%%%%%%%    %%%%
%%%%%%%%%%%%%%%%%%%%%%%%%%%%%%%%%%%%%    %%%%
%%%%%%%%%%%%%%%%%%%%%%%%%%%%%%%%%%%%%    %%%%
%%%%%%%%%%%%%%%%%%%%%%%%%%%%%%%%%%%%%    %%%%
%%%%%%%%%%%%%%%%%%%%%%%%%%%%%%%%%%%%%    %%%%
%%%%%%%%%%%%%%%%%%%%%%%%%%%%%%%%%%%%     %%%%
%%%%%%%%%%%%%%%%%%%%%%%%%%%%%%%%%%%      %%%%
%%%%%%%%%%%%%%%%%%%%%%%%%%%%%%%%%%       %%%%
%%%%%%%%%%%%%%%%%%%%%%%%%%%%%%%%%%%%%%%%%%%%%
%%                   %%%%%%%%%%%%%%%%%%%%%%%%
%%%%%%%%%%%%%%%%%%%%%%%%%%%%%%%%%%%%%%%%%%%%%
%%%%%%%%%%%%%%%%%%%%%%%%%%%%%%%%%%%%%%%%%%%%%
%%%%%%%%%%%%%%%%%%%%%%%%%%%%%%%%%%%%%%%%%%%%%
%%%%%%%%%%%%%%%%%%%%%%%%%%%%%%%%%%%%%%%%%%%%%
%%%%%%%%%%%%%%%%%%%%%%%%%%%%%%%%%%%%%%%%%%%%%
%%%%%%%%%%%%%%%%%%%%%%%%%%%%%%%%%%%%%%%%%%%%%
%%%%%%%%%%%%%%%%%%%%%%%%%%%%%%%%%%%%%%%%%%%%%
%%%%%%%%%%%%%%%%%%%%%%%%%%%%%%%%%%%%%%%%%%%%%
%%%%%%%%%%%%%%%%%%%%%%%%%%%%%%%%%%%%%%%%%%%%%
%%%%%%%%%%%%%%%%%%%%%%%%%%%%               %%
%%%%%%%%%%%%%%%%%%%%%%%%%%%%%%%%%%%%%%%%%%%%%
%%%%%%%%%%%%%%%%%%%%%%%%%%%%%%%%%%%%%%%%%%%%%
%%%%%%%%%%%%%%%%%%%%%%%%%%%%%%%%%%%%%%%%%%%%%
%%%%%%%%%%%%%%%%%%%%%%%%%%%%%%%%%%%%%%%%%%%%%
%%%%%%%%%%%%%%%%%%%%%%%%%%%%%%%%%%%%%%%%%%%%%
%%%%%%%%%%%%%%%%%%%%%%%%%%%%%%%%%%%%%%%%%%%%%
#
